catai	catai
@openai/codex	codex
@google/gemini-cli	gemini-cli
how2	how2
appium	appium
esbuild	esbuild
jake	jake
pkg	pkg
rollup	rollup
@rspack/cli	rspack
tsup	tsup
vite	vite
webpack	webpack
aws-cdk	aws-cdk
cloudflare	create-cloudflare
eas-cli	eas-cli
firebase-tools	firebase-tools
wrangler	wrangler
devspace	devspace
kctx	kctx
strip-json-comments-cli	strip-json-comments-cli
trzsz	trzsz
supabase	supabase
docsify-cli	docsify-cli
genji-theme-vitepress	genji
@nore-dev/fman	fman
fd-find	fd
ncp	ncp
taskbook	taskbook
sass	dart-sass
@angular/cli	angular
@biomejs/biome	biome
bun	bun
concurrently	concurrently
eslint	eslint
hint	hint
lynx-cli	lynx-cli
nodemon	nodemon
np	np
pm2	pm2
release-it	release-it
taze	taze
ts-node	ts-node
tsx	tsx
rasti	rasti
alex	alex
cspell	cspell
lint-staged	lint-staged
oxlint	oxlint
prettier	prettier
decktape	decktape
marked	marked
@marp-team/marp-cli	marp-cli
minify	minify
readability-cli	readability-cli
stylelint	stylelint
easy-sharing	easy-sharing
gomplate	gomplate
nanoid	nanoid
carbon-now-cli	carbon-now-cli
carbonyl	carbonyl
editly	editly
@mermaid-js/mermaid-cli	mermaid-cli
mystmd	mystmd
nasa-cli	nasa-cli
pageres-cli	pageres-cli
terminal-image-cli	terminal-image-cli
themer	themer
tinify	tinify
fanyi	fanyi
franc-cli	franc-cli
@bufbuild/buf	buf
fast-cli	fast-cli
is-online-cli	is-online-cli
is-up-cli	is-up-cli
json-server	json-server
localtunnel	localtunnel
neoss	neoss
public-ip-cli	public-ip-cli
t-get	t-get
wetty	wetty
fkill-cli	fkill-cli
gtop	gtop
mprocs	mprocs
vtop	vtop
bcat	bcat
concat-md	concat-md
emoj	emoj
mapscii	mapscii
nb.sh	nb.sh
shelljs	shelljs
shx	shx
wait-on	wait-on
pnpm	pnpm
yarn	yarn
cloc	cloc
@changesets/cli	changesets
semantic-release	semantic-release
czg	czg
git-split-diffs	git-split-diffs
gitmoji-cli	gitmoji-cli
lefthook	lefthook
arctic	arctic
snyk	snyk
stegcloak	stegcloak
nushell	nushell
zx	zx
bnfgen	bnfgen
chatbot-ui	chatbot-ui
coap-cli	coap-cli
gem-book	gem-book
jilla	jilla
jira-cmd	jira-cmd
markdownlint-cli	markdownlint-cli
markdownlint-cli2	markdownlint-cli2
markedpp	markedpp
md-fileserver	md-fileserver
mongosh	mongosh
newman	newman
redis-commander	redis-commander
cfonts	cfonts
loadtest	loadtest
@bytecodealliance/jco	jco
google-indexing-script	google-indexing-script
webtorrent-cli	webtorrent-cli
@stoplight/elements	elements
httpyac	httpyac
@orangeopensource/hurl	hurl
browser-run	browser-run
capture-website-cli	capture-website-cli
playwright	playwright
minio	minio
serve	serve
htmx.org	htmx
hygen	hygen
yo	yo
